QWERTY
backspace, enter, tab, esc, space
shift, ctrl, alt, cmd, l, r
+-----------------------------------------------.                    +-----------------------------------------------+
|       |   Q   |   W   |   E   |   R   |   T   |                    |   Y   |   U   |   I   |   O   |   P   |       |
|-------+-------+-------+-------+-------+-------|                    |-------+-------+-------+-------+-------+-------|
|       |   A   |   S   |   D   |   F   |   G   |                    |   H   |   J   |   K   |   L   |   '   |       |
|-------+-------+-------+-------+-------+-------|-------+    +-------|-------+-------+-------+-------+-------+-------|
|       |   Z   |   X   |   C   |   V   |   B   |       |    |       |   N   |   M   |   ,   |   .   |   ?   |       |
+-------+-------+-------+-------+-------+-------+-------|    |-------+-------+-------+-------+-------+-------+-------+
                        |       |  BSPC | SPC/sh| tab/N |    | esc/S |   M   | ent/S |       |
                        +-------------------------------+    +-------------------------------+

MOD
+-----------------------------------------------.                    +-----------------------------------------------+
|       |       |       |  C-E  |  C-R  |  S-T  |                    |       |       |       |  S-O  |  S-P  |       |
|-------+-------+-------+-------+-------+-------|                    |-------+-------+-------+-------+-------+-------|
|       |  C-A  |  S-S  |  C-D  |  S-F  |  C-G  |                    |  HYP  |  cmd  |  ctrl |  alt  |  shft |       |
|-------+-------+-------+-------+-------+-------|-------+    +-------|-------+-------+-------+-------+-------+-------|
|       |  S-Z  |  S-X  |  S-C  |  S-V  |       |       |    |       |  S-N  |       |   S-, |       |       |       |
+-------+-------+-------+-------+-------+-------+-------|    |-------+-------+-------+-------+-------+-------+-------+
                        |       |       |       |       |    |       |       |       |       |
                        +-------------------------------+    +-------------------------------+

SYM
+-----------------------------------------------.                    +-----------------------------------------------+
|       |       |   *   |   +   |   -   |   /   |                    |   $   |   &   |   |   |   ^   |   ]   |       |
|-------+-------+-------+-------+-------+-------|                    |-------+-------+-------+-------+-------+-------|
|       |   )   |  (    |   [   |   {   |   @   |                    |   !   |   :   |   "   |   _   |   ;   |       |
|-------+-------+-------+-------+-------+-------|-------+    +-------|-------+-------+-------+-------+-------+-------|
|       |   \   |  `    |   #   |   =   |   ~   |       |    |       |       |   %   |   <   |   >   |   }   |       |
+-------+-------+-------+-------+-------+-------+-------|    |-------+-------+-------+-------+-------+-------+-------+
                        |       |       |       |       |    |       |       |       |       |
                        +-------------------------------+    +-------------------------------+

NAV_NUM
+-----------------------------------------------.                    +-----------------------------------------------+
|       |       |   8   |   7   |   6   |   5   |                    |       |       |       |       |      |        |
|-------+-------+-------+-------+-------+-------|                    |-------+-------+-------+-------+-------+-------|
|       |   4   |   3   |   2   |   1   |   0   |                    | left  | down  |  up   | right |       |       |
|-------+-------+-------+-------+-------+-------|-------+    +-------|-------+-------+-------+-------+-------+-------|
|       |       |       |       |       |   9   |       |    |       |  M-L  | pgdn  | pgup  |  M-R  |       |       |
+-------+-------+-------+-------+-------+-------+-------|    |-------+-------+-------+-------+-------+-------+-------+
                        |       |       |       |       |    |       |       |       |       |
                        +-------------------------------+    +-------------------------------+

ADJ
+-----------------------------------------------.                    +-----------------------------------------------+
|       |  MR1  |  MRR1 | MRSTP | L/OSX | cpslk |                    |       | bridn | briup |       | PSCR  |       |
|-------+-------+-------+-------+-------+-------|                    |-------+-------+-------+-------+-------+-------|
|       |  F11  |       |  prv  | pl/pau|  nxt  |                    |  mute | voldn | volup |       |  F12  |       |
|-------+-------+-------+-------+-------+-------|-------+    +-------|-------+-------+-------+-------+-------+-------|
|       |   F1  |   F2  |   F3  |   F4  |   F5  |       |    |       |   F6  |   F7  |  F8   |   F9  |  F10  |       |
+-------+-------+-------+-------+-------+-------+-------|    |-------+-------+-------+-------+-------+-------+-------+
                        |       | RESET |       |       |    |       |       |       |       |
                        +-------------------------------+    +-------------------------------+
